Date,Control Point,Arrival / Departure,Hong Kong Residents,Mainland Visitors,Other Visitors,Total
1/1/2024,Airport,Arrival,59647,4851,10011,74509
1/1/2024,Airport,Departure,19330,11546,30575,61451
2/1/2024,Airport,Arrival,47450,6715,13580,67745
2/1/2024,Airport,Departure,23922,7870,27863,59655
3/1/2024,Airport,Arrival,36822,7505,16242,60569
3/1/2024,Airport,Departure,24330,6400,22206,52936
4/1/2024,Airport,Arrival,30057,6704,17216,53977
4/1/2024,Airport,Departure,25699,5186,16894,47779
5/1/2024,Airport,Arrival,29506,7050,17919,54475
5/1/2024,Airport,Departure,28070,6348,16889,51307
6/1/2024,Airport,Arrival,33311,7237,16273,56821
6/1/2024,Airport,Departure,25796,6035,18362,50193
7/1/2024,Airport,Arrival,38936,7287,14987,61210
7/1/2024,Airport,Departure,24984,8645,21244,54873
8/1/2024,Airport,Arrival,29348,7256,16265,52869
8/1/2024,Airport,Departure,24500,6832,17871,49203
9/1/2024,Airport,Arrival,24998,5995,14655,45648
9/1/2024,Airport,Departure,22197,6280,15204,43681
10/1/2024,Airport,Arrival,23985,6741,15272,45998
10/1/2024,Airport,Departure,24528,6549,15198,46275
11/1/2024,Airport,Arrival,22164,7499,16891,46554
11/1/2024,Airport,Departure,26278,6574,15241,48093
12/1/2024,Airport,Arrival,23898,8960,17735,50593
12/1/2024,Airport,Departure,29083,7510,17099,53692
13-01-2024,Airport,Arrival,26255,8390,17994,52639
13-01-2024,Airport,Departure,25521,7021,15709,48251
14-01-2024,Airport,Arrival,34095,8248,16421,58764
14-01-2024,Airport,Departure,22824,9676,20798,53298
15-01-2024,Airport,Arrival,29107,9368,16505,54980
15-01-2024,Airport,Departure,22291,7710,16582,46583
16-01-2024,Airport,Arrival,24117,8093,15456,47666
16-01-2024,Airport,Departure,19570,7356,16245,43171
17-01-2024,Airport,Arrival,23696,9221,16488,49405
17-01-2024,Airport,Departure,21744,7451,14819,44014
18-01-2024,Airport,Arrival,20882,9047,18415,48344
18-01-2024,Airport,Departure,24780,7703,14516,46999
19-01-2024,Airport,Arrival,22969,11114,20191,54274
19-01-2024,Airport,Departure,27882,9014,16351,53247
20-01-2024,Airport,Arrival,24648,11701,18384,54733
20-01-2024,Airport,Departure,24496,9997,16940,51433
21-01-2024,Airport,Arrival,31279,11386,16040,58705
21-01-2024,Airport,Departure,21015,12401,21758,55174
22-01-2024,Airport,Arrival,25297,11228,16100,52625
22-01-2024,Airport,Departure,20962,10873,18343,50178
23-01-2024,Airport,Arrival,22507,11229,15154,48890
23-01-2024,Airport,Departure,18135,10875,16499,45509
24-01-2024,Airport,Arrival,21041,11189,16145,48375
24-01-2024,Airport,Departure,21068,11122,15365,47555
25-01-2024,Airport,Arrival,19078,11639,19263,49980
25-01-2024,Airport,Departure,24450,11302,15163,50915
26-01-2024,Airport,Arrival,20852,12240,20472,53564
26-01-2024,Airport,Departure,26917,12719,16624,56260
27-01-2024,Airport,Arrival,22095,14187,17753,54035
27-01-2024,Airport,Departure,23847,13492,17588,54927
28-01-2024,Airport,Arrival,29198,13870,14748,57816
28-01-2024,Airport,Departure,20933,14526,23558,59017
29-01-2024,Airport,Arrival,24559,14146,13733,52438
29-01-2024,Airport,Departure,18904,12354,19378,50636
30-01-2024,Airport,Arrival,22043,13190,11701,46934
30-01-2024,Airport,Departure,17291,13385,17708,48384
31-01-2024,Airport,Arrival,21509,13281,12477,47267
31-01-2024,Airport,Departure,20871,14432,16116,51419
1/2/2024,Airport,Arrival,18194,14040,16160,48394
1/2/2024,Airport,Departure,23631,15274,13946,52851
2/2/2024,Airport,Arrival,18736,13773,15503,48012
2/2/2024,Airport,Departure,27824,16281,15089,59194
3/2/2024,Airport,Arrival,20656,15056,14602,50314
3/2/2024,Airport,Departure,28387,15829,15692,59908
4/2/2024,Airport,Arrival,25238,15129,11621,51988
4/2/2024,Airport,Departure,23120,15615,20260,58995
5/2/2024,Airport,Arrival,22011,14846,9840,46697
5/2/2024,Airport,Departure,21708,16750,16177,54635
6/2/2024,Airport,Arrival,19840,15618,9118,44576
6/2/2024,Airport,Departure,33375,15615,13812,62802
7/2/2024,Airport,Arrival,21152,17138,12223,50513
7/2/2024,Airport,Departure,46023,11561,10981,68565
8/2/2024,Airport,Arrival,22902,17444,16448,56794
8/2/2024,Airport,Departure,50573,9516,9205,69294
9/2/2024,Airport,Arrival,18425,13191,17586,49202
9/2/2024,Airport,Departure,60485,5942,6781,73208
10/2/2024,Airport,Arrival,15659,15127,17116,47902
10/2/2024,Airport,Departure,49687,7223,7481,64391
11/2/2024,Airport,Arrival,17292,17937,13100,48329
11/2/2024,Airport,Departure,39349,10866,11911,62126
12/2/2024,Airport,Arrival,26994,17682,10993,55669
12/2/2024,Airport,Departure,34397,12898,15258,62553
13-02-2024,Airport,Arrival,45037,12699,8336,66072
13-02-2024,Airport,Departure,31605,14318,15111,61034
14-02-2024,Airport,Arrival,42578,14947,10141,67666
14-02-2024,Airport,Departure,26422,15187,14298,55907
15-02-2024,Airport,Arrival,40851,17636,12223,70710
15-02-2024,Airport,Departure,28570,15004,12165,55739
16-02-2024,Airport,Arrival,45486,17689,12528,75703
16-02-2024,Airport,Departure,25739,14913,11039,51691
17-02-2024,Airport,Arrival,54467,13446,10800,78713
17-02-2024,Airport,Departure,25552,13418,12065,51035
18-02-2024,Airport,Arrival,61938,9532,10526,81996
18-02-2024,Airport,Departure,25125,12544,13949,51618
19-02-2024,Airport,Arrival,43974,15547,13852,73373
19-02-2024,Airport,Departure,21866,10541,9612,42019
20-02-2024,Airport,Arrival,32674,16084,15641,64399
20-02-2024,Airport,Departure,19215,9609,9780,38604
21-02-2024,Airport,Arrival,26423,15072,18144,59639
21-02-2024,Airport,Departure,20261,8521,9541,38323
22-02-2024,Airport,Arrival,21279,12573,22463,56315
22-02-2024,Airport,Departure,24921,8392,11207,44520
23-02-2024,Airport,Arrival,21610,10426,25161,57197
23-02-2024,Airport,Departure,28393,10122,14311,52826
24-02-2024,Airport,Arrival,22299,9136,22774,54209
24-02-2024,Airport,Departure,25730,8979,16026,50735
25-02-2024,Airport,Arrival,31026,9332,21600,61958
25-02-2024,Airport,Departure,22713,10120,24805,57638
26-02-2024,Airport,Arrival,27678,9168,22342,59188
26-02-2024,Airport,Departure,21242,7140,22227,50609
27-02-2024,Airport,Arrival,25220,7309,20100,52629
27-02-2024,Airport,Departure,19372,6523,19206,45101
28-02-2024,Airport,Arrival,22532,7463,23310,53305
28-02-2024,Airport,Departure,20651,6867,19092,46610
29-02-2024,Airport,Arrival,21924,7180,20569,49673
29-02-2024,Airport,Departure,25072,7258,18180,50510
1/3/2024,Airport,Arrival,21754,7837,22277,51868
1/3/2024,Airport,Departure,32781,7049,17078,56908
2/3/2024,Airport,Arrival,22720,6950,18733,48403
2/3/2024,Airport,Departure,26943,6330,21134,54407
3/3/2024,Airport,Arrival,29697,6974,16520,53191
3/3/2024,Airport,Departure,24526,7490,25875,57891
4/3/2024,Airport,Arrival,27057,6927,18229,52213
4/3/2024,Airport,Departure,23466,6065,22167,51698
5/3/2024,Airport,Arrival,22960,5629,17310,45899
5/3/2024,Airport,Departure,20034,5869,18646,44549
6/3/2024,Airport,Arrival,21658,6450,16744,44852
6/3/2024,Airport,Departure,22609,5542,16729,44880
7/3/2024,Airport,Arrival,20985,7349,19120,47454
7/3/2024,Airport,Departure,25696,5479,16392,47567
8/3/2024,Airport,Arrival,25161,9476,20924,55561
8/3/2024,Airport,Departure,30803,6201,17400,54404
9/3/2024,Airport,Arrival,24868,6976,20104,51948
9/3/2024,Airport,Departure,26371,6883,17577,50831
10/3/2024,Airport,Arrival,34570,8045,18220,60835
10/3/2024,Airport,Departure,24576,9011,23123,56710
11/3/2024,Airport,Arrival,27722,7379,19020,54121
11/3/2024,Airport,Departure,23610,6365,18498,48473
12/3/2024,Airport,Arrival,23911,6156,15521,45588
12/3/2024,Airport,Departure,21343,5525,16612,43480
13-03-2024,Airport,Arrival,22538,7243,17932,47713
13-03-2024,Airport,Departure,23214,6059,15861,45134
14-03-2024,Airport,Arrival,20590,7546,18476,46612
14-03-2024,Airport,Departure,27507,6783,15991,50281
15-03-2024,Airport,Arrival,25646,9097,21232,55975
15-03-2024,Airport,Departure,30763,6945,17849,55557
16-03-2024,Airport,Arrival,24928,8108,19482,52518
16-03-2024,Airport,Departure,26739,6443,17944,51126
17-03-2024,Airport,Arrival,32985,8078,17991,59054
17-03-2024,Airport,Departure,26086,9103,23454,58643
18-03-2024,Airport,Arrival,27804,8712,18194,54710
18-03-2024,Airport,Departure,26340,7602,18965,52907
19-03-2024,Airport,Arrival,24541,7126,14377,46044
19-03-2024,Airport,Departure,23371,6943,16361,46675
20-03-2024,Airport,Arrival,23746,8716,16816,49278
20-03-2024,Airport,Departure,28184,7299,17065,52548
21-03-2024,Airport,Arrival,23106,8947,17690,49743
21-03-2024,Airport,Departure,32683,6946,16576,56205
22-03-2024,Airport,Arrival,27628,11142,20093,58863
22-03-2024,Airport,Departure,39981,7321,16783,64085
23-03-2024,Airport,Arrival,27123,9473,18821,55417
23-03-2024,Airport,Departure,41572,6190,15731,63493
24-03-2024,Airport,Arrival,34618,9402,16527,60547
24-03-2024,Airport,Departure,36003,9664,20353,66020
25-03-2024,Airport,Arrival,28088,10130,16139,54357
25-03-2024,Airport,Departure,35667,8482,18237,62386
26-03-2024,Airport,Arrival,27294,8816,16077,52187
26-03-2024,Airport,Departure,46016,6051,14628,66695
27-03-2024,Airport,Arrival,27102,9013,19842,55957
27-03-2024,Airport,Departure,55493,4736,14656,74885
28-03-2024,Airport,Arrival,29406,8711,20092,58209
28-03-2024,Airport,Departure,66294,3675,11822,81791
29-03-2024,Airport,Arrival,30510,10174,19962,60646
29-03-2024,Airport,Departure,66102,4561,13040,83703
30-03-2024,Airport,Arrival,33871,9782,16986,60639
30-03-2024,Airport,Departure,44713,6277,18866,69856
31-03-2024,Airport,Arrival,39636,7594,12871,60101
31-03-2024,Airport,Departure,37043,8700,24198,69941
1/4/2024,Airport,Arrival,58645,4580,10964,74189
1/4/2024,Airport,Departure,37721,6908,19178,63807
2/4/2024,Airport,Arrival,47976,5554,12353,65883
2/4/2024,Airport,Departure,32357,6541,14974,53872
3/4/2024,Airport,Arrival,43105,8631,16703,68439
3/4/2024,Airport,Departure,32019,8110,12737,52866
4/4/2024,Airport,Arrival,46441,7401,19136,72978
4/4/2024,Airport,Departure,29650,6230,11588,47468
5/4/2024,Airport,Arrival,48391,6316,18672,73379
5/4/2024,Airport,Departure,23459,6826,12462,42747
6/4/2024,Airport,Arrival,54283,5669,16331,76283
6/4/2024,Airport,Departure,25130,10400,15494,51024
7/4/2024,Airport,Arrival,62471,5423,13472,81366
7/4/2024,Airport,Departure,27134,8729,21963,57826
8/4/2024,Airport,Arrival,44718,8591,17244,70553
8/4/2024,Airport,Departure,26524,6073,18675,51272
9/4/2024,Airport,Arrival,32110,7917,18985,59012
9/4/2024,Airport,Departure,22984,6957,15809,45750
10/4/2024,Airport,Arrival,25687,8459,23434,57580
10/4/2024,Airport,Departure,25089,7929,19210,52228
11/4/2024,Airport,Arrival,21885,8292,21324,51501
11/4/2024,Airport,Departure,27124,7258,15079,49461
12/4/2024,Airport,Arrival,24613,8552,24389,57554
12/4/2024,Airport,Departure,30705,8177,17066,55948
13-04-2024,Airport,Arrival,25872,7678,22337,55887
13-04-2024,Airport,Departure,27410,7004,19832,54246
14-04-2024,Airport,Arrival,33511,8269,18926,60706
14-04-2024,Airport,Departure,26569,9088,24260,59917
15-04-2024,Airport,Arrival,28028,9672,19068,56768
15-04-2024,Airport,Departure,24927,7400,21336,53663
16-04-2024,Airport,Arrival,23780,7929,15339,47048
16-04-2024,Airport,Departure,21813,6839,19983,48635
17-04-2024,Airport,Arrival,22885,8856,17246,48987
17-04-2024,Airport,Departure,24080,7262,18037,49379
18-04-2024,Airport,Arrival,22102,7866,18383,48351
18-04-2024,Airport,Departure,27932,6938,16693,51563
19-04-2024,Airport,Arrival,24431,9038,19581,53050
19-04-2024,Airport,Departure,29837,8615,18450,56902
20-04-2024,Airport,Arrival,25359,8992,19300,53651
20-04-2024,Airport,Departure,26541,8302,19604,54447
21-04-2024,Airport,Arrival,31755,9339,17426,58520
21-04-2024,Airport,Departure,25715,10183,23607,59505
22-04-2024,Airport,Arrival,30620,9559,17399,57578
22-04-2024,Airport,Departure,24814,8502,18258,51574
23-04-2024,Airport,Arrival,23383,8651,13927,45961
23-04-2024,Airport,Departure,22920,7854,16893,47667
24-04-2024,Airport,Arrival,24418,8362,16794,49574
24-04-2024,Airport,Departure,24542,7653,18269,50464
25-04-2024,Airport,Arrival,23523,8170,16320,48013
25-04-2024,Airport,Departure,27360,7649,16138,51147
26-04-2024,Airport,Arrival,23463,9317,19437,52217
26-04-2024,Airport,Departure,31856,11136,17393,60385
27-04-2024,Airport,Arrival,25506,9372,20887,55765
27-04-2024,Airport,Departure,29132,14281,17585,60998
28-04-2024,Airport,Arrival,31020,10364,14940,56324
28-04-2024,Airport,Departure,22482,12120,22594,57196
29-04-2024,Airport,Arrival,27718,11262,12188,51168
29-04-2024,Airport,Departure,17558,14977,19217,51752
30-04-2024,Airport,Arrival,22249,12827,11577,46653
30-04-2024,Airport,Departure,21092,23672,17726,62490
1/5/2024,Airport,Arrival,31253,16663,16730,64646
1/5/2024,Airport,Departure,24086,23814,16173,64073
2/5/2024,Airport,Arrival,22871,13907,15144,51922
2/5/2024,Airport,Departure,20505,15344,13583,49432
3/5/2024,Airport,Arrival,16975,14305,19394,50674
3/5/2024,Airport,Departure,22738,10994,12612,46344
4/5/2024,Airport,Arrival,16871,18290,14305,49466
4/5/2024,Airport,Departure,23089,12700,14904,50693
5/5/2024,Airport,Arrival,31615,30404,13150,75169
5/5/2024,Airport,Departure,23024,13615,22100,58739
6/5/2024,Airport,Arrival,24074,24475,14142,62691
6/5/2024,Airport,Departure,22399,9192,20542,52133
7/5/2024,Airport,Arrival,19954,15227,12840,48021
7/5/2024,Airport,Departure,25739,7403,12421,45563
8/5/2024,Airport,Arrival,19138,10574,14468,44180
8/5/2024,Airport,Departure,27875,6483,10866,45224
9/5/2024,Airport,Arrival,18474,7300,14725,40499
9/5/2024,Airport,Departure,30143,6727,11509,48379
10/5/2024,Airport,Arrival,21914,7018,15698,44630
10/5/2024,Airport,Departure,37172,6620,13727,57519
11/5/2024,Airport,Arrival,23488,5988,15086,44562
11/5/2024,Airport,Departure,37935,5702,13352,56989
12/5/2024,Airport,Arrival,30221,7797,13315,51333
12/5/2024,Airport,Departure,30626,6660,18393,55679
13-05-2024,Airport,Arrival,23814,7875,13163,44852
13-05-2024,Airport,Departure,28694,5868,13823,48385
14-05-2024,Airport,Arrival,25531,6522,12131,44184
14-05-2024,Airport,Departure,32911,5538,12696,51145
15-05-2024,Airport,Arrival,34932,7193,13960,56085
15-05-2024,Airport,Departure,38897,5300,12923,57120
16-05-2024,Airport,Arrival,27279,8781,14557,50617
16-05-2024,Airport,Departure,27964,6340,11957,46261
17-05-2024,Airport,Arrival,27070,9254,16552,52876
17-05-2024,Airport,Departure,30715,6906,13186,50807
18-05-2024,Airport,Arrival,32682,8534,15554,56770
18-05-2024,Airport,Departure,29628,7249,14954,51831
19-05-2024,Airport,Arrival,46268,7205,12441,65914
19-05-2024,Airport,Departure,28566,9520,18693,56779
20-05-2024,Airport,Arrival,35424,8447,13923,57794
20-05-2024,Airport,Departure,28665,6807,13860,49332
21-05-2024,Airport,Arrival,29174,8001,13138,50313
21-05-2024,Airport,Departure,25219,5951,12766,43936
22-05-2024,Airport,Arrival,25134,7910,15571,48615
22-05-2024,Airport,Departure,27047,5835,12408,45290
23-05-2024,Airport,Arrival,23142,8646,16011,47799
23-05-2024,Airport,Departure,30388,5849,12118,48355
24-05-2024,Airport,Arrival,28826,10039,17565,56430
24-05-2024,Airport,Departure,34926,7115,13287,55328
25-05-2024,Airport,Arrival,29868,8790,17356,56014
25-05-2024,Airport,Departure,31987,7090,15130,54207
26-05-2024,Airport,Arrival,37690,8725,15843,62258
26-05-2024,Airport,Departure,30678,9114,20152,59944
27-05-2024,Airport,Arrival,31815,8848,16056,56719
27-05-2024,Airport,Departure,29286,7507,16110,52903
28-05-2024,Airport,Arrival,28133,7095,12715,47943
28-05-2024,Airport,Departure,24871,6343,14226,45440
29-05-2024,Airport,Arrival,26791,6925,13271,46987
29-05-2024,Airport,Departure,25663,6060,13228,44951
30-05-2024,Airport,Arrival,25423,7842,14043,47308
30-05-2024,Airport,Departure,28364,6134,15303,49801
31-05-2024,Airport,Arrival,28825,9582,16385,54792
31-05-2024,Airport,Departure,32398,6897,15115,54410
1/6/2024,Airport,Arrival,28534,7760,17986,54280
1/6/2024,Airport,Departure,32486,6484,14357,53327
2/6/2024,Airport,Arrival,38370,7788,14218,60376
2/6/2024,Airport,Departure,28049,9886,18038,55973
3/6/2024,Airport,Arrival,30535,7388,13857,51780
3/6/2024,Airport,Departure,26873,6974,16855,50702
4/6/2024,Airport,Arrival,26321,6165,11615,44101
4/6/2024,Airport,Departure,23778,5717,13429,42924
5/6/2024,Airport,Arrival,24625,6934,14784,46343
5/6/2024,Airport,Departure,29277,6192,12460,47929
6/6/2024,Airport,Arrival,24393,8383,18006,50782
6/6/2024,Airport,Departure,36905,7327,12246,56478
7/6/2024,Airport,Arrival,25621,12017,18802,56440
7/6/2024,Airport,Departure,47451,8160,12338,67949
8/6/2024,Airport,Arrival,27577,11963,19996,59536
8/6/2024,Airport,Departure,42180,7645,14708,64533
9/6/2024,Airport,Arrival,32291,7891,13514,53696
9/6/2024,Airport,Departure,29885,7792,19369,57046
10/6/2024,Airport,Arrival,52062,9185,12798,74045
10/6/2024,Airport,Departure,26297,10783,20146,57226
11/6/2024,Airport,Arrival,38029,10109,13613,61751
11/6/2024,Airport,Departure,26338,8317,14171,48826
12/6/2024,Airport,Arrival,31631,9508,15679,56818
12/6/2024,Airport,Departure,27020,6279,12696,45995
13-06-2024,Airport,Arrival,25933,8503,16331,50767
13-06-2024,Airport,Departure,29720,6190,11873,47783
14-06-2024,Airport,Arrival,27505,10579,19037,57121
14-06-2024,Airport,Departure,36007,7447,13517,56971
15-06-2024,Airport,Arrival,30219,9748,18686,58653
15-06-2024,Airport,Departure,33081,7085,14656,54822
16-06-2024,Airport,Arrival,39182,9351,16049,64582
16-06-2024,Airport,Departure,29917,8940,18477,57334
17-06-2024,Airport,Arrival,29479,9686,16036,55201
17-06-2024,Airport,Departure,30113,8999,18175,57287
18-06-2024,Airport,Arrival,33890,8612,15262,57764
18-06-2024,Airport,Departure,27450,7183,16064,50697
19-06-2024,Airport,Arrival,26715,9326,16730,52771
19-06-2024,Airport,Departure,30212,6603,14266,51081
20-06-2024,Airport,Arrival,26162,8907,16659,51728
20-06-2024,Airport,Departure,34145,7079,13878,55102
21-06-2024,Airport,Arrival,29651,9713,18095,57459
21-06-2024,Airport,Departure,38637,8164,15385,62186
22-06-2024,Airport,Arrival,30719,10055,17525,58299
22-06-2024,Airport,Departure,35059,7733,16086,58878
23-06-2024,Airport,Arrival,39249,9611,15636,64496
23-06-2024,Airport,Departure,31952,9009,20508,61469
24-06-2024,Airport,Arrival,34946,10523,16595,62064
24-06-2024,Airport,Departure,31393,7822,17782,56997
25-06-2024,Airport,Arrival,30831,9312,14458,54601
25-06-2024,Airport,Departure,31189,7839,15332,54360
26-06-2024,Airport,Arrival,29555,9926,14788,54269
26-06-2024,Airport,Departure,35440,7479,15278,58197
27-06-2024,Airport,Arrival,29098,10271,15717,55086
27-06-2024,Airport,Departure,44686,6837,14544,66067
28-06-2024,Airport,Arrival,31807,10836,17168,59811
28-06-2024,Airport,Departure,53422,6775,13518,73715
29-06-2024,Airport,Arrival,34015,10749,17557,62321
29-06-2024,Airport,Departure,50763,6773,15107,72643
30-06-2024,Airport,Arrival,40289,10224,13847,64360
30-06-2024,Airport,Departure,38106,9741,19469,67316
1/7/2024,Airport,Arrival,53350,7086,12873,73309
1/7/2024,Airport,Departure,32099,8142,15627,55868
2/7/2024,Airport,Arrival,44005,8322,12536,64863
2/7/2024,Airport,Departure,30306,8043,13808,52157
3/7/2024,Airport,Arrival,35825,9617,14583,60025
3/7/2024,Airport,Departure,29140,8518,13328,50986
4/7/2024,Airport,Arrival,30936,9651,15692,56279
4/7/2024,Airport,Departure,31790,8371,12826,52987
5/7/2024,Airport,Arrival,30058,10634,16845,57537
5/7/2024,Airport,Departure,35143,9772,14328,59243
6/7/2024,Airport,Arrival,33394,10043,14973,58410
6/7/2024,Airport,Departure,32411,10782,14688,57881
7/7/2024,Airport,Arrival,41160,9656,13525,64341
7/7/2024,Airport,Departure,29537,12416,18461,60414
8/7/2024,Airport,Arrival,34875,10936,14208,60019
8/7/2024,Airport,Departure,28156,10700,15072,53928
9/7/2024,Airport,Arrival,30765,9958,12626,53349
9/7/2024,Airport,Departure,26097,9947,13643,49687
10/7/2024,Airport,Arrival,27925,10603,13425,51953
10/7/2024,Airport,Departure,30433,10317,13501,54251
11/7/2024,Airport,Arrival,27706,10861,14742,53309
11/7/2024,Airport,Departure,34643,10965,13226,58834
12/7/2024,Airport,Arrival,27689,11347,16383,55419
12/7/2024,Airport,Departure,43505,11517,13066,68088
13-07-2024,Airport,Arrival,30073,11406,15893,57372
13-07-2024,Airport,Departure,39488,11960,13204,64652
14-07-2024,Airport,Arrival,37443,11718,12813,61974
14-07-2024,Airport,Departure,34995,13772,17656,66423
15-07-2024,Airport,Arrival,35175,12743,14170,62088
15-07-2024,Airport,Departure,33172,11895,16865,61932
16-07-2024,Airport,Arrival,30429,11251,12542,54222
16-07-2024,Airport,Departure,33538,10976,13111,57625
17-07-2024,Airport,Arrival,27993,11221,12863,52077
17-07-2024,Airport,Departure,38183,10041,12932,61156
18-07-2024,Airport,Arrival,28305,12001,14415,54721
18-07-2024,Airport,Departure,42215,10031,12301,64547
19-07-2024,Airport,Arrival,30312,12237,15901,58450
19-07-2024,Airport,Departure,45492,11093,13285,69870
20-07-2024,Airport,Arrival,34294,12051,16348,62693
20-07-2024,Airport,Departure,43380,11253,13065,67698
21-07-2024,Airport,Arrival,43258,12309,13247,68814
21-07-2024,Airport,Departure,40844,12756,17752,71352
22-07-2024,Airport,Arrival,38294,12864,14239,65397
22-07-2024,Airport,Departure,38547,10485,16624,65656
23-07-2024,Airport,Arrival,36026,11636,12314,59976
23-07-2024,Airport,Departure,33790,10465,13887,58142
24-07-2024,Airport,Arrival,33040,11930,13879,58849
24-07-2024,Airport,Departure,36106,9904,12429,58439
25-07-2024,Airport,Arrival,32054,12356,13836,58246
25-07-2024,Airport,Departure,39715,10690,13915,64320
26-07-2024,Airport,Arrival,36350,12991,17271,66612
26-07-2024,Airport,Departure,44448,11194,14865,70507
27-07-2024,Airport,Arrival,36768,11892,17901,66561
27-07-2024,Airport,Departure,42651,11373,14873,68897
28-07-2024,Airport,Arrival,46007,12669,13854,72530
28-07-2024,Airport,Departure,37227,12758,18521,68506
29-07-2024,Airport,Arrival,43546,13394,13660,70600
29-07-2024,Airport,Departure,34586,11144,18565,64295
30-07-2024,Airport,Arrival,38571,11390,11588,61549
30-07-2024,Airport,Departure,31492,10969,15916,58377
31-07-2024,Airport,Arrival,39416,12445,12230,64091
31-07-2024,Airport,Departure,35438,10274,15022,60734
1/8/2024,Airport,Arrival,35765,13712,14735,64212
1/8/2024,Airport,Departure,42705,10081,12472,65258
2/8/2024,Airport,Arrival,36080,14551,15016,65647
2/8/2024,Airport,Departure,43151,11405,12960,67516
3/8/2024,Airport,Arrival,38386,13511,14651,66548
3/8/2024,Airport,Departure,40025,11219,14019,65263
4/8/2024,Airport,Arrival,45842,12455,12235,70532
4/8/2024,Airport,Departure,35848,13642,17845,67335
5/8/2024,Airport,Arrival,42013,14184,13246,69443
5/8/2024,Airport,Departure,35014,13750,13887,62651
6/8/2024,Airport,Arrival,40504,13073,12231,65808
6/8/2024,Airport,Departure,31268,12372,13186,56826
7/8/2024,Airport,Arrival,37427,12974,13182,63583
7/8/2024,Airport,Departure,33311,12081,12604,57996
8/8/2024,Airport,Arrival,34935,13308,15496,63739
8/8/2024,Airport,Departure,37595,11766,11894,61255
9/8/2024,Airport,Arrival,39165,13711,17205,70081
9/8/2024,Airport,Departure,41340,12494,12608,66442
10/8/2024,Airport,Arrival,40509,13324,16668,70501
10/8/2024,Airport,Departure,36090,12066,13695,61851
11/8/2024,Airport,Arrival,50068,12421,13792,76281
11/8/2024,Airport,Departure,32210,14352,18771,65333
12/8/2024,Airport,Arrival,44612,14503,14246,73361
12/8/2024,Airport,Departure,30329,12237,17806,60372
13-08-2024,Airport,Arrival,40743,12548,13498,66789
13-08-2024,Airport,Departure,27508,12047,14776,54331
14-08-2024,Airport,Arrival,35690,13064,15610,64364
14-08-2024,Airport,Departure,30971,11579,13806,56356
15-08-2024,Airport,Arrival,32147,13106,17000,62253
15-08-2024,Airport,Departure,34458,12037,13618,60113
16-08-2024,Airport,Arrival,34495,14826,17570,66891
16-08-2024,Airport,Departure,36126,12150,13888,62164
17-08-2024,Airport,Arrival,34167,13899,14742,62808
17-08-2024,Airport,Departure,34830,11504,16968,63302
18-08-2024,Airport,Arrival,46583,13312,13559,73454
18-08-2024,Airport,Departure,33266,13134,20539,66939
19-08-2024,Airport,Arrival,38805,14061,14349,67215
19-08-2024,Airport,Departure,32805,12364,15835,61004
20-08-2024,Airport,Arrival,35641,13203,12577,61421
20-08-2024,Airport,Departure,30129,11208,13972,55309
21-08-2024,Airport,Arrival,33539,14028,13831,61398
21-08-2024,Airport,Departure,33878,11212,13663,58753
22-08-2024,Airport,Arrival,30304,14305,15045,59654
22-08-2024,Airport,Departure,37028,10588,12436,60052
23-08-2024,Airport,Arrival,32825,15750,17843,66418
23-08-2024,Airport,Departure,41459,11592,12674,65725
24-08-2024,Airport,Arrival,36205,13730,16297,66232
24-08-2024,Airport,Departure,37403,12049,14087,63539
25-08-2024,Airport,Arrival,47430,12950,14149,74529
25-08-2024,Airport,Departure,34015,13747,19109,66871
26-08-2024,Airport,Arrival,44043,12953,13889,70885
26-08-2024,Airport,Departure,31658,11711,17576,60945
27-08-2024,Airport,Arrival,37558,11166,11979,60703
27-08-2024,Airport,Departure,27316,10554,14347,52217
28-08-2024,Airport,Arrival,37173,10979,12566,60718
28-08-2024,Airport,Departure,28310,10186,13741,52237
29-08-2024,Airport,Arrival,35926,10132,13420,59478
29-08-2024,Airport,Departure,27523,9579,12893,49995
30-08-2024,Airport,Arrival,37168,9210,15189,61567
30-08-2024,Airport,Departure,30545,10657,12220,53422
31-08-2024,Airport,Arrival,40475,7715,13956,62146
31-08-2024,Airport,Departure,28124,8830,13241,50195
1/9/2024,Airport,Arrival,44473,7745,13568,65786
1/9/2024,Airport,Departure,28208,9640,16087,53935
2/9/2024,Airport,Arrival,30025,8628,15950,54603
2/9/2024,Airport,Departure,24742,7236,12314,44292
3/9/2024,Airport,Arrival,22543,7875,16292,46710
3/9/2024,Airport,Departure,22950,6631,11877,41458
4/9/2024,Airport,Arrival,20617,6674,13345,40636
4/9/2024,Airport,Departure,24866,6517,11795,43178
5/9/2024,Airport,Arrival,18108,6732,12724,37564
5/9/2024,Airport,Departure,28218,6974,12541,47733
6/9/2024,Airport,Arrival,19831,5871,12957,38659
6/9/2024,Airport,Departure,27310,5739,14388,47437
7/9/2024,Airport,Arrival,26186,7458,14903,48547
7/9/2024,Airport,Departure,28754,7001,16829,52584
8/9/2024,Airport,Arrival,34293,7572,13896,55761
8/9/2024,Airport,Departure,26188,8869,17733,52790
9/9/2024,Airport,Arrival,29897,8237,13911,52045
9/9/2024,Airport,Departure,24632,6645,12666,43943
10/9/2024,Airport,Arrival,25029,7631,12745,45405
10/9/2024,Airport,Departure,21226,5645,12084,38955
11/9/2024,Airport,Arrival,23446,6604,13357,43407
11/9/2024,Airport,Departure,22287,6141,12047,40475
12/9/2024,Airport,Arrival,22109,6851,15390,44350
12/9/2024,Airport,Departure,26421,6702,13192,46315
13-09-2024,Airport,Arrival,25500,8832,21062,55394
13-09-2024,Airport,Departure,35582,9215,14404,59201
14-09-2024,Airport,Arrival,24846,10498,25903,61247
14-09-2024,Airport,Departure,34749,10268,14340,59357
15-09-2024,Airport,Arrival,31997,10244,20639,62880
15-09-2024,Airport,Departure,24364,10972,17304,52640
16-09-2024,Airport,Arrival,26279,6394,17209,49882
16-09-2024,Airport,Departure,20066,7311,19630,47007
17-09-2024,Airport,Arrival,21509,11206,16295,49010
17-09-2024,Airport,Departure,25216,10224,20612,56052
18-09-2024,Airport,Arrival,30334,10212,16163,56709
18-09-2024,Airport,Departure,35924,7005,15074,58003
19-09-2024,Airport,Arrival,21243,7628,15008,43879
19-09-2024,Airport,Departure,28907,6263,14563,49733
20-09-2024,Airport,Arrival,20528,7732,16374,44634
20-09-2024,Airport,Departure,33900,7171,15558,56629
21-09-2024,Airport,Arrival,26252,8533,17296,52081
21-09-2024,Airport,Departure,29469,7071,18594,55134
22-09-2024,Airport,Arrival,41192,8209,15217,64618
22-09-2024,Airport,Departure,26717,9800,23496,60013
23-09-2024,Airport,Arrival,35417,8844,14988,59249
23-09-2024,Airport,Departure,26800,7888,19480,54168
24-09-2024,Airport,Arrival,27443,7061,13130,47634
24-09-2024,Airport,Departure,23589,6736,15512,45837
25-09-2024,Airport,Arrival,24419,6852,12955,44226
25-09-2024,Airport,Departure,26401,8036,14642,49079
26-09-2024,Airport,Arrival,23127,7416,13542,44085
26-09-2024,Airport,Departure,31206,10466,15241,56913
27-09-2024,Airport,Arrival,27202,8302,15031,50535
27-09-2024,Airport,Departure,39710,14256,14877,68843
28-09-2024,Airport,Arrival,27764,9390,14535,51689
28-09-2024,Airport,Departure,35467,18977,16180,70624
29-09-2024,Airport,Arrival,33753,8340,10761,52854
29-09-2024,Airport,Departure,23518,18059,21104,62681
30-09-2024,Airport,Arrival,33208,11626,10106,54940
30-09-2024,Airport,Departure,17708,26969,15301,59978
1/10/2024,Airport,Arrival,40774,12140,10480,63394
1/10/2024,Airport,Departure,17694,31850,11989,61533
2/10/2024,Airport,Arrival,28539,12995,12369,53903
2/10/2024,Airport,Departure,16324,22973,10782,50079
3/10/2024,Airport,Arrival,19070,13309,15633,48012
3/10/2024,Airport,Departure,20389,16970,10887,48246
4/10/2024,Airport,Arrival,21908,18679,16381,56968
4/10/2024,Airport,Departure,30041,12616,11400,54057
5/10/2024,Airport,Arrival,22485,24271,15485,62241
5/10/2024,Airport,Departure,32009,11986,12521,56516
6/10/2024,Airport,Arrival,27725,30451,13624,71800
6/10/2024,Airport,Departure,26258,12398,16954,55610
7/10/2024,Airport,Arrival,20786,40031,12360,73177
7/10/2024,Airport,Departure,24867,10298,11729,46894
8/10/2024,Airport,Arrival,20974,27982,14563,63519
8/10/2024,Airport,Departure,27720,7380,10751,45851
9/10/2024,Airport,Arrival,21995,17562,21356,60913
9/10/2024,Airport,Departure,37560,5367,11078,54005
10/10/2024,Airport,Arrival,22835,11387,24270,58492
10/10/2024,Airport,Departure,54046,4103,10083,68232
11/10/2024,Airport,Arrival,26373,7412,23327,57112
11/10/2024,Airport,Departure,48410,4437,11412,64259
12/10/2024,Airport,Arrival,35274,6635,24476,66385
12/10/2024,Airport,Departure,26844,5135,17502,49481
13-10-2024,Airport,Arrival,57519,5417,16377,79313
13-10-2024,Airport,Departure,27717,5321,24524,57562
14-10-2024,Airport,Arrival,46593,7507,18822,72922
14-10-2024,Airport,Departure,27418,5447,22528,55393
15-10-2024,Airport,Arrival,36621,6474,18224,61319
15-10-2024,Airport,Departure,25264,5141,16824,47229
16-10-2024,Airport,Arrival,29747,6990,18486,55223
16-10-2024,Airport,Departure,27163,5907,15342,48412
17-10-2024,Airport,Arrival,25701,6992,20026,52719
17-10-2024,Airport,Departure,30938,5702,14967,51607
18-10-2024,Airport,Arrival,29197,8085,22034,59316
18-10-2024,Airport,Departure,37350,6418,17410,61178
19-10-2024,Airport,Arrival,31703,7151,21705,60559
19-10-2024,Airport,Departure,35267,6036,19399,60702
20-10-2024,Airport,Arrival,41828,6874,19081,67783
20-10-2024,Airport,Departure,30406,7758,25747,63911
21-10-2024,Airport,Arrival,35022,7495,18874,61391
21-10-2024,Airport,Departure,28154,6534,19069,53757
22-10-2024,Airport,Arrival,29055,6545,17064,52664
22-10-2024,Airport,Departure,24411,5388,17050,46849
23-10-2024,Airport,Arrival,28391,6932,19232,54555
23-10-2024,Airport,Departure,26465,6124,16917,49506
24-10-2024,Airport,Arrival,26326,7027,18869,52222
24-10-2024,Airport,Departure,30954,6021,16986,53961
25-10-2024,Airport,Arrival,31301,8618,22059,61978
25-10-2024,Airport,Departure,35901,6916,19292,62109
26-10-2024,Airport,Arrival,33559,7488,23203,64250
26-10-2024,Airport,Departure,31462,6825,20138,58425
27-10-2024,Airport,Arrival,41048,6985,19332,67365
27-10-2024,Airport,Departure,25994,7962,24825,58781
28-10-2024,Airport,Arrival,33955,7737,18505,60197
28-10-2024,Airport,Departure,25315,6198,19511,51024
29-10-2024,Airport,Arrival,29348,6546,16861,52755
29-10-2024,Airport,Departure,20691,5504,17338,43533
30-10-2024,Airport,Arrival,28257,6469,20382,55108
30-10-2024,Airport,Departure,24109,6568,18749,49426
31-10-2024,Airport,Arrival,25007,7449,20543,52999
31-10-2024,Airport,Departure,26317,6129,17768,50214
1/11/2024,Airport,Arrival,25932,7223,23125,56280
1/11/2024,Airport,Departure,35672,6566,19630,61868
2/11/2024,Airport,Arrival,26496,6239,21868,54603
2/11/2024,Airport,Departure,30333,6280,21939,58552
3/11/2024,Airport,Arrival,36008,6563,17834,60405
3/11/2024,Airport,Departure,27281,7673,26879,61833
4/11/2024,Airport,Arrival,32895,7606,18681,59182
4/11/2024,Airport,Departure,26865,6110,24897,57872
5/11/2024,Airport,Arrival,26129,6836,16629,49594
5/11/2024,Airport,Departure,24425,5387,18173,47985
6/11/2024,Airport,Arrival,25454,6355,19150,50959
6/11/2024,Airport,Departure,26757,5319,17165,49241
7/11/2024,Airport,Arrival,24384,6984,20393,51761
7/11/2024,Airport,Departure,32321,5441,15890,53652
8/11/2024,Airport,Arrival,27447,7982,21988,57417
8/11/2024,Airport,Departure,37095,6834,18186,62115
9/11/2024,Airport,Arrival,28850,7079,20343,56272
9/11/2024,Airport,Departure,33479,6717,18462,58658
10/11/2024,Airport,Arrival,38923,7212,18729,64864
10/11/2024,Airport,Departure,29280,8125,24730,62135
11/11/2024,Airport,Arrival,34528,8989,20837,64354
11/11/2024,Airport,Departure,27787,7043,21326,56156
12/11/2024,Airport,Arrival,28880,7937,20122,56939
12/11/2024,Airport,Departure,24868,5840,17666,48374
13-11-2024,Airport,Arrival,26498,7176,20076,53750
13-11-2024,Airport,Departure,27668,5638,17509,50815
14-11-2024,Airport,Arrival,25395,7413,20102,52910
14-11-2024,Airport,Departure,32480,6795,17795,57070
15-11-2024,Airport,Arrival,29881,9327,22938,62146
15-11-2024,Airport,Departure,37354,7842,21638,66834
16-11-2024,Airport,Arrival,31248,8070,22190,61508
16-11-2024,Airport,Departure,32684,7098,22537,62319
17-11-2024,Airport,Arrival,39676,8654,19325,67655
17-11-2024,Airport,Departure,29634,9527,26987,66148
18-11-2024,Airport,Arrival,36161,8861,19458,64480
18-11-2024,Airport,Departure,29684,7499,22471,59654
19-11-2024,Airport,Arrival,29503,6597,16684,52784
19-11-2024,Airport,Departure,25448,5863,18321,49632
20-11-2024,Airport,Arrival,26856,7077,18826,52759
20-11-2024,Airport,Departure,28135,6575,17891,52601
21-11-2024,Airport,Arrival,26209,7724,21809,55742
21-11-2024,Airport,Departure,35063,6441,17288,58792
22-11-2024,Airport,Arrival,30397,8454,23985,62836
22-11-2024,Airport,Departure,38930,6799,17823,63552
23-11-2024,Airport,Arrival,30239,7317,22062,59618
23-11-2024,Airport,Departure,33472,5961,20099,59532
24-11-2024,Airport,Arrival,40119,7966,19126,67211
24-11-2024,Airport,Departure,29032,8525,27238,64795
25-11-2024,Airport,Arrival,36944,8076,19148,64168
25-11-2024,Airport,Departure,28154,6720,22227,57101
26-11-2024,Airport,Arrival,30614,7012,16965,54591
26-11-2024,Airport,Departure,25137,5628,19038,49803
27-11-2024,Airport,Arrival,27596,7477,19643,54716
27-11-2024,Airport,Departure,27989,6325,18103,52417
28-11-2024,Airport,Arrival,27276,7540,21341,56157
28-11-2024,Airport,Departure,32692,6697,16804,56193
29-11-2024,Airport,Arrival,29619,9789,23491,62899
29-11-2024,Airport,Departure,36125,7419,19255,62799
30-11-2024,Airport,Arrival,32284,8235,21846,62365
30-11-2024,Airport,Departure,33324,6722,20901,60947
1/12/2024,Airport,Arrival,40664,7566,18869,67099
1/12/2024,Airport,Departure,29278,8932,26208,64418
2/12/2024,Airport,Arrival,35036,8611,19228,62875
2/12/2024,Airport,Departure,27947,7983,21534,57464
3/12/2024,Airport,Arrival,28133,6958,17325,52416
3/12/2024,Airport,Departure,24865,5915,17940,48720
4/12/2024,Airport,Arrival,26274,7173,19427,52874
4/12/2024,Airport,Departure,26729,6037,17545,50311
5/12/2024,Airport,Arrival,24539,8560,22916,56015
5/12/2024,Airport,Departure,31212,6269,18546,56027
6/12/2024,Airport,Arrival,28764,10308,23093,62165
6/12/2024,Airport,Departure,36884,7765,18388,63037
7/12/2024,Airport,Arrival,27869,8465,23259,59593
7/12/2024,Airport,Departure,33710,7349,21053,62112
8/12/2024,Airport,Arrival,39376,8711,20258,68345
8/12/2024,Airport,Departure,28110,9496,27140,64746
9/12/2024,Airport,Arrival,34575,9150,20391,64116
9/12/2024,Airport,Departure,26819,7562,23708,58089
10/12/2024,Airport,Arrival,29702,7575,18381,55658
10/12/2024,Airport,Departure,24814,6511,22020,53345
11/12/2024,Airport,Arrival,26936,8075,18899,53910
11/12/2024,Airport,Departure,27713,6458,19861,54032
12/12/2024,Airport,Arrival,26413,9962,21289,57664
12/12/2024,Airport,Departure,34568,6917,18637,60122
13-12-2024,Airport,Arrival,28848,10505,22628,61981
13-12-2024,Airport,Departure,44731,7992,17366,70089
14-12-2024,Airport,Arrival,30839,9085,23028,62952
14-12-2024,Airport,Departure,43612,7228,19004,69844
15-12-2024,Airport,Arrival,38382,12972,18598,69952
15-12-2024,Airport,Departure,35759,10260,25609,71628
16-12-2024,Airport,Arrival,37569,10805,19562,67936
16-12-2024,Airport,Departure,33771,7701,22616,64088
17-12-2024,Airport,Arrival,31668,9763,16420,57851
17-12-2024,Airport,Departure,34859,7053,19952,61864
18-12-2024,Airport,Arrival,30108,9524,18162,57794
18-12-2024,Airport,Departure,38755,10989,19038,68782
19-12-2024,Airport,Arrival,28667,10006,21019,59692
19-12-2024,Airport,Departure,49432,7758,19769,76959
20-12-2024,Airport,Arrival,32100,11788,22854,66742
20-12-2024,Airport,Departure,58950,6557,17919,83426
21-12-2024,Airport,Arrival,30502,11909,26869,69280
21-12-2024,Airport,Departure,67770,5054,14023,86847
22-12-2024,Airport,Arrival,34906,10159,23744,68809
22-12-2024,Airport,Departure,55190,7653,19544,82387
23-12-2024,Airport,Arrival,32809,10648,25029,68486
23-12-2024,Airport,Departure,50036,7408,19792,77236
24-12-2024,Airport,Arrival,29547,8908,23320,61775
24-12-2024,Airport,Departure,53331,5404,15261,73996
25-12-2024,Airport,Arrival,31576,7741,27173,66490
25-12-2024,Airport,Departure,50903,4979,16445,72327
26-12-2024,Airport,Arrival,44271,8010,25855,78136
26-12-2024,Airport,Departure,45579,6893,20783,73255
27-12-2024,Airport,Arrival,42633,8304,28398,79335
27-12-2024,Airport,Departure,41929,7031,20668,69628
28-12-2024,Airport,Arrival,44741,7002,29187,80930
28-12-2024,Airport,Departure,36246,7899,23263,67408
29-12-2024,Airport,Arrival,61283,4959,21920,88162
29-12-2024,Airport,Departure,29153,8350,27866,65369
30-12-2024,Airport,Arrival,53989,6105,24649,84743
30-12-2024,Airport,Departure,25039,6734,26481,58254
31-12-2024,Airport,Arrival,54969,6411,20460,81840
31-12-2024,Airport,Departure,23557,7303,22071,52931
1/1/2023,Airport,Arrival,24925,1687,2456,29068
1/1/2023,Airport,Departure,14591,1648,4644,20883
2/1/2023,Airport,Arrival,28258,1624,1857,31739
2/1/2023,Airport,Departure,13367,1422,6713,21502
3/1/2023,Airport,Arrival,22993,1663,2459,27115
3/1/2023,Airport,Departure,14179,1652,4621,20452
4/1/2023,Airport,Arrival,21850,1886,2833,26569
4/1/2023,Airport,Departure,14230,1533,3740,19503
5/1/2023,Airport,Arrival,18429,2304,3164,23897
5/1/2023,Airport,Departure,14417,1434,3422,19273
6/1/2023,Airport,Arrival,19307,2468,3391,25166
6/1/2023,Airport,Departure,15155,1684,3308,20147
7/1/2023,Airport,Arrival,19863,2885,3456,26204
7/1/2023,Airport,Departure,15927,1590,3585,21102
8/1/2023,Airport,Arrival,23121,3019,4135,30275
8/1/2023,Airport,Departure,18344,2949,4410,25703
9/1/2023,Airport,Arrival,17190,3403,4203,24796
9/1/2023,Airport,Departure,13750,2286,3384,19420
10/1/2023,Airport,Arrival,16424,3419,4169,24012
10/1/2023,Airport,Departure,13894,2533,3931,20358
11/1/2023,Airport,Arrival,15408,3777,4088,23273
11/1/2023,Airport,Departure,14288,2732,4596,21616
12/1/2023,Airport,Arrival,15014,3769,4270,23053
12/1/2023,Airport,Departure,15030,2686,4797,22513
13-01-2023,Airport,Arrival,15451,3834,4362,23647
13-01-2023,Airport,Departure,15924,3286,5093,24303
14-01-2023,Airport,Arrival,17309,3548,3969,24826
14-01-2023,Airport,Departure,17507,3075,5448,26030
15-01-2023,Airport,Arrival,20690,3469,3799,27958
15-01-2023,Airport,Departure,17647,3631,6205,27483
16-01-2023,Airport,Arrival,15596,3389,3432,22417
16-01-2023,Airport,Departure,13712,2934,4649,21295
17-01-2023,Airport,Arrival,15066,3476,3125,21667
17-01-2023,Airport,Departure,18842,2870,4633,26345
18-01-2023,Airport,Arrival,15805,3984,3744,23533
18-01-2023,Airport,Departure,24707,2837,4046,31590
19-01-2023,Airport,Arrival,15193,4444,4389,24026
19-01-2023,Airport,Departure,28640,2393,3684,34717
20-01-2023,Airport,Arrival,14481,4068,5256,23805
20-01-2023,Airport,Departure,31647,1913,2809,36369
21-01-2023,Airport,Arrival,13577,2435,5535,21547
21-01-2023,Airport,Departure,31799,1036,2422,35257
22-01-2023,Airport,Arrival,11142,3126,4307,18575
22-01-2023,Airport,Departure,28517,1484,2934,32935
23-01-2023,Airport,Arrival,12358,4214,4380,20952
23-01-2023,Airport,Departure,21687,1810,2898,26395
24-01-2023,Airport,Arrival,16309,3690,4251,24250
24-01-2023,Airport,Departure,19487,2219,4172,25878
25-01-2023,Airport,Arrival,25033,2938,3305,31276
25-01-2023,Airport,Departure,19642,2668,3704,26014
26-01-2023,Airport,Arrival,24394,3869,4224,32487
26-01-2023,Airport,Departure,17807,3511,3986,25304
27-01-2023,Airport,Arrival,25531,2955,3898,32384
27-01-2023,Airport,Departure,17747,4291,4348,26386
28-01-2023,Airport,Arrival,30702,2225,3008,35935
28-01-2023,Airport,Departure,18069,3715,4938,26722
29-01-2023,Airport,Arrival,37062,1582,2481,41125
29-01-2023,Airport,Departure,17984,4058,5617,27659
30-01-2023,Airport,Arrival,28849,2883,3382,35114
30-01-2023,Airport,Departure,13318,3244,3733,20295
31-01-2023,Airport,Arrival,25658,2933,3577,32168
31-01-2023,Airport,Departure,13285,3203,3547,20035
1/2/2023,Airport,Arrival,22962,3951,4675,31588
1/2/2023,Airport,Departure,16309,3230,3012,22551
2/2/2023,Airport,Arrival,18327,5118,5619,29064
2/2/2023,Airport,Departure,14632,3203,3180,21015
3/2/2023,Airport,Arrival,15487,4576,6473,26536
3/2/2023,Airport,Departure,16961,3651,3724,24336
4/2/2023,Airport,Arrival,17592,4583,5697,27872
4/2/2023,Airport,Departure,15644,3405,3957,23006
5/2/2023,Airport,Arrival,21913,3859,5410,31182
5/2/2023,Airport,Departure,16539,3598,5739,25876
6/2/2023,Airport,Arrival,17408,4946,6154,28508
6/2/2023,Airport,Departure,14145,3686,4586,22417
7/2/2023,Airport,Arrival,14729,4539,5653,24921
7/2/2023,Airport,Departure,13399,3598,4811,21808
8/2/2023,Airport,Arrival,14464,4953,6021,25438
8/2/2023,Airport,Departure,14257,3978,4614,22849
9/2/2023,Airport,Arrival,13494,5226,7014,25734
9/2/2023,Airport,Departure,15208,3904,4593,23705
10/2/2023,Airport,Arrival,14019,4865,7265,26149
10/2/2023,Airport,Departure,17789,4472,5570,27831
11/2/2023,Airport,Arrival,15727,4650,6667,27044
11/2/2023,Airport,Departure,16394,4234,5723,26351
12/2/2023,Airport,Arrival,17921,4288,6717,28926
12/2/2023,Airport,Departure,16926,4720,7800,29446
13-02-2023,Airport,Arrival,15957,5122,6676,27755
13-02-2023,Airport,Departure,13582,4093,6160,23835
14-02-2023,Airport,Arrival,12967,4309,6452,23728
14-02-2023,Airport,Departure,12803,3926,5614,22343
15-02-2023,Airport,Arrival,14140,4821,7383,26344
15-02-2023,Airport,Departure,15365,4397,5550,25312
16-02-2023,Airport,Arrival,13690,5449,7430,26569
16-02-2023,Airport,Departure,15655,4072,5573,25300
17-02-2023,Airport,Arrival,15179,5341,7799,28319
17-02-2023,Airport,Departure,17401,4603,6906,28910
18-02-2023,Airport,Arrival,15655,4827,6912,27394
18-02-2023,Airport,Departure,16800,4320,6808,27928
19-02-2023,Airport,Arrival,19652,5012,7128,31792
19-02-2023,Airport,Departure,16973,5504,8721,31198
20-02-2023,Airport,Arrival,17015,5555,7588,30158
20-02-2023,Airport,Departure,15120,4602,6803,26525
21-02-2023,Airport,Arrival,14958,4814,6700,26472
21-02-2023,Airport,Departure,13592,4612,6128,24332
22-02-2023,Airport,Arrival,14788,5418,7954,28160
22-02-2023,Airport,Departure,14849,4808,6600,26257
23-02-2023,Airport,Arrival,13891,6026,9170,29087
23-02-2023,Airport,Departure,16221,4799,6212,27232
24-02-2023,Airport,Arrival,15912,5544,10054,31510
24-02-2023,Airport,Departure,18644,5311,7216,31171
25-02-2023,Airport,Arrival,16842,5346,10473,32661
25-02-2023,Airport,Departure,16784,5137,7588,29509
26-02-2023,Airport,Arrival,20734,5086,8471,34291
26-02-2023,Airport,Departure,16701,6027,10098,32826
27-02-2023,Airport,Arrival,17988,5321,9668,32977
27-02-2023,Airport,Departure,14937,5112,9084,29133
28-02-2023,Airport,Arrival,15694,5373,9930,30997
28-02-2023,Airport,Departure,15016,5381,9603,30000
1/3/2023,Airport,Arrival,15504,5536,10681,31721
1/3/2023,Airport,Departure,18657,5106,7668,31431
2/3/2023,Airport,Arrival,14072,6010,9617,29699
2/3/2023,Airport,Departure,19251,5031,6360,30642
3/3/2023,Airport,Arrival,14834,6097,9665,30596
3/3/2023,Airport,Departure,20844,5456,7568,33868
4/3/2023,Airport,Arrival,16002,5326,8161,29489
4/3/2023,Airport,Departure,18792,5066,8719,32577
5/3/2023,Airport,Arrival,21017,5639,7508,34164
5/3/2023,Airport,Departure,18147,5579,12729,36455
6/3/2023,Airport,Arrival,17444,5899,7924,31267
6/3/2023,Airport,Departure,15573,5137,11805,32515
7/3/2023,Airport,Arrival,16023,5490,7296,28809
7/3/2023,Airport,Departure,16045,5253,9613,30911
8/3/2023,Airport,Arrival,15816,6068,7892,29776
8/3/2023,Airport,Departure,18292,5217,7791,31300
9/3/2023,Airport,Arrival,15807,6956,9029,31792
9/3/2023,Airport,Departure,19956,5021,7144,32121
10/3/2023,Airport,Arrival,17275,6780,9504,33559
10/3/2023,Airport,Departure,21097,5884,8074,35055
11/3/2023,Airport,Arrival,18602,6105,8714,33421
11/3/2023,Airport,Departure,19077,5511,7808,32396
12/3/2023,Airport,Arrival,22811,5950,8402,37163
12/3/2023,Airport,Departure,19025,6978,10347,36350
13-03-2023,Airport,Arrival,20079,6847,8605,35531
13-03-2023,Airport,Departure,17209,5768,8439,31416
14-03-2023,Airport,Arrival,17214,5517,7592,30323
14-03-2023,Airport,Departure,17421,5360,7364,30145
15-03-2023,Airport,Arrival,17600,6784,8653,33037
15-03-2023,Airport,Departure,18814,5849,7569,32232
16-03-2023,Airport,Arrival,16554,7337,9439,33330
16-03-2023,Airport,Departure,20151,5224,7662,33037
17-03-2023,Airport,Arrival,18219,7706,10661,36586
17-03-2023,Airport,Departure,22119,6150,8679,36948
18-03-2023,Airport,Arrival,18830,6731,9777,35338
18-03-2023,Airport,Departure,19318,5569,8509,33396
19-03-2023,Airport,Arrival,23592,6934,9626,40152
19-03-2023,Airport,Departure,19497,6715,11008,37220
20-03-2023,Airport,Arrival,20381,7708,9943,38032
20-03-2023,Airport,Departure,18250,5980,8466,32696
21-03-2023,Airport,Arrival,18316,6826,8892,34034
21-03-2023,Airport,Departure,17193,5556,8808,31557
22-03-2023,Airport,Arrival,18217,7537,9405,35159
22-03-2023,Airport,Departure,19207,5553,8322,33082
23-03-2023,Airport,Arrival,17309,7993,10153,35455
23-03-2023,Airport,Departure,21103,5491,8390,34984
24-03-2023,Airport,Arrival,18689,8532,10183,37404
24-03-2023,Airport,Departure,23581,6429,9468,39478
25-03-2023,Airport,Arrival,20412,7074,8458,35944
25-03-2023,Airport,Departure,20723,6388,9564,36675
26-03-2023,Airport,Arrival,23755,7758,9221,40734
26-03-2023,Airport,Departure,21607,8545,12243,42395
27-03-2023,Airport,Arrival,20658,7454,9445,37557
27-03-2023,Airport,Departure,20524,6639,10259,37422
28-03-2023,Airport,Arrival,18349,6594,7599,32542
28-03-2023,Airport,Departure,21442,6426,8948,36816
29-03-2023,Airport,Arrival,18069,6851,9820,34740
29-03-2023,Airport,Departure,23914,5504,10131,39549
30-03-2023,Airport,Arrival,19113,7936,9672,36721
30-03-2023,Airport,Departure,29192,5335,8650,43177
31-03-2023,Airport,Arrival,20670,8068,11162,39900
31-03-2023,Airport,Departure,38933,4640,6930,50503
1/4/2023,Airport,Arrival,20233,7497,12238,39968
1/4/2023,Airport,Departure,42951,3696,6133,52780
2/4/2023,Airport,Arrival,23030,6101,10358,39489
2/4/2023,Airport,Departure,37175,5536,9270,51981
3/4/2023,Airport,Arrival,17354,5598,8827,31779
3/4/2023,Airport,Departure,31278,4536,10036,45850
4/4/2023,Airport,Arrival,18108,4975,9046,32129
4/4/2023,Airport,Departure,40373,3734,7107,51214
5/4/2023,Airport,Arrival,19096,6386,11184,36666
5/4/2023,Airport,Departure,40673,3489,7124,51286
6/4/2023,Airport,Arrival,20312,5516,12707,38535
6/4/2023,Airport,Departure,36760,3370,7211,47341
7/4/2023,Airport,Arrival,25465,5401,11774,42640
7/4/2023,Airport,Departure,33517,4187,8081,45785
8/4/2023,Airport,Arrival,31803,4777,8523,45103
8/4/2023,Airport,Departure,23236,4935,10075,38246
9/4/2023,Airport,Arrival,43770,3770,7061,54601
9/4/2023,Airport,Departure,26634,7025,13112,46771
10/4/2023,Airport,Arrival,48380,3499,5143,57022
10/4/2023,Airport,Departure,24601,4959,11284,40844
11/4/2023,Airport,Arrival,41402,4912,8422,54736
11/4/2023,Airport,Departure,25537,4674,9068,39279
12/4/2023,Airport,Arrival,35053,5086,13008,53147
12/4/2023,Airport,Departure,22287,4604,9201,36092
13-04-2023,Airport,Arrival,32049,6152,11956,50157
13-04-2023,Airport,Departure,21549,4774,7444,33767
14-04-2023,Airport,Arrival,34359,6142,11124,51625
14-04-2023,Airport,Departure,23216,6439,9099,38754
15-04-2023,Airport,Arrival,36669,5257,8455,50381
15-04-2023,Airport,Departure,21533,6475,10417,38425
16-04-2023,Airport,Arrival,39806,5666,8401,53873
16-04-2023,Airport,Departure,23427,7818,12355,43600
17-04-2023,Airport,Arrival,27195,8233,11696,47124
17-04-2023,Airport,Departure,21017,6266,9126,36409
18-04-2023,Airport,Arrival,22517,7425,12658,42600
18-04-2023,Airport,Departure,20009,5888,8620,34517
19-04-2023,Airport,Arrival,20224,7128,13218,40570
19-04-2023,Airport,Departure,20275,5843,9151,35269
20-04-2023,Airport,Arrival,18904,7472,14328,40704
20-04-2023,Airport,Departure,21368,6320,10495,38183
21-04-2023,Airport,Arrival,20900,7272,14676,42848
21-04-2023,Airport,Departure,23506,6734,12037,42277
22-04-2023,Airport,Arrival,19916,6743,12337,38996
22-04-2023,Airport,Departure,20295,6883,12780,39958
23-04-2023,Airport,Arrival,25392,7717,12055,45164
23-04-2023,Airport,Departure,21021,7053,14928,43002
24-04-2023,Airport,Arrival,21930,7549,11171,40650
24-04-2023,Airport,Departure,18645,5541,12126,36312
25-04-2023,Airport,Arrival,22169,7722,9146,39037
25-04-2023,Airport,Departure,17427,6213,12788,36428
26-04-2023,Airport,Arrival,20500,8106,10938,39544
26-04-2023,Airport,Departure,19435,7176,13638,40249
27-04-2023,Airport,Arrival,19034,9994,11568,40596
27-04-2023,Airport,Departure,21255,9467,12242,42964
28-04-2023,Airport,Arrival,18518,11095,14462,44075
28-04-2023,Airport,Departure,25757,12030,11397,49184
29-04-2023,Airport,Arrival,17557,12068,15082,44707
29-04-2023,Airport,Departure,22088,13292,11190,46570
30-04-2023,Airport,Arrival,22969,9444,10032,42445
30-04-2023,Airport,Departure,17714,9184,13214,40112
1/5/2023,Airport,Arrival,30221,7340,7966,45527
1/5/2023,Airport,Departure,13817,7776,16127,37720
2/5/2023,Airport,Arrival,22359,8947,8618,39924
2/5/2023,Airport,Departure,15314,9974,11928,37216
3/5/2023,Airport,Arrival,17070,13733,11080,41883
3/5/2023,Airport,Departure,16996,10803,9811,37610
4/5/2023,Airport,Arrival,14277,11613,12063,37953
4/5/2023,Airport,Departure,19030,7694,8460,35184
5/5/2023,Airport,Arrival,14450,8908,11971,35329
5/5/2023,Airport,Departure,22283,6145,9834,38262
6/5/2023,Airport,Arrival,16141,7992,9535,33668
6/5/2023,Airport,Departure,19910,6882,11076,37868
7/5/2023,Airport,Arrival,21682,9280,10247,41209
7/5/2023,Airport,Departure,19720,7596,14718,42034
8/5/2023,Airport,Arrival,18962,7790,10602,37354
8/5/2023,Airport,Departure,21235,6004,9948,37187
9/5/2023,Airport,Arrival,17266,7557,9850,34673
9/5/2023,Airport,Departure,20849,5757,9279,35885
10/5/2023,Airport,Arrival,18309,7888,10134,36331
10/5/2023,Airport,Departure,22619,5383,8180,36182
11/5/2023,Airport,Arrival,17336,8999,10380,36715
11/5/2023,Airport,Departure,22598,6400,8335,37333
12/5/2023,Airport,Arrival,18454,8846,10884,38184
12/5/2023,Airport,Departure,25768,7100,10157,43025
13-05-2023,Airport,Arrival,20516,8234,9533,38283
13-05-2023,Airport,Departure,22629,6339,10163,39131
14-05-2023,Airport,Arrival,25785,8169,9532,43486
14-05-2023,Airport,Departure,22499,8482,12107,43088
15-05-2023,Airport,Arrival,22836,8461,10401,41698
15-05-2023,Airport,Departure,24764,7178,9695,41637
16-05-2023,Airport,Arrival,20380,7014,9533,36927
16-05-2023,Airport,Departure,21955,6419,9201,37575
17-05-2023,Airport,Arrival,19986,7088,10440,37514
17-05-2023,Airport,Departure,24381,6194,8890,39465
18-05-2023,Airport,Arrival,20020,9009,11145,40174
18-05-2023,Airport,Departure,24808,6019,8685,39512
19-05-2023,Airport,Arrival,21698,8387,12150,42235
19-05-2023,Airport,Departure,28430,6688,9718,44836
20-05-2023,Airport,Arrival,23600,7296,10067,40963
20-05-2023,Airport,Departure,26532,5926,10577,43035
21-05-2023,Airport,Arrival,27798,7099,9639,44536
21-05-2023,Airport,Departure,24859,7398,12970,45227
22-05-2023,Airport,Arrival,24635,7632,9118,41385
22-05-2023,Airport,Departure,23587,6100,10906,40593
23-05-2023,Airport,Arrival,22481,6927,9121,38529
23-05-2023,Airport,Departure,24718,5664,10260,40642
24-05-2023,Airport,Arrival,21616,6923,10174,38713
24-05-2023,Airport,Departure,29887,5194,8428,43509
25-05-2023,Airport,Arrival,22506,7684,11680,41870
25-05-2023,Airport,Departure,33349,5103,7412,45864
26-05-2023,Airport,Arrival,24324,7582,13112,45018
26-05-2023,Airport,Departure,30775,6043,8862,45680
27-05-2023,Airport,Arrival,28428,7254,10775,46457
27-05-2023,Airport,Departure,21175,5702,10122,36999
28-05-2023,Airport,Arrival,38521,5769,7901,52191
28-05-2023,Airport,Departure,21749,6877,13022,41648
29-05-2023,Airport,Arrival,31517,6933,8127,46577
29-05-2023,Airport,Departure,20949,5954,12035,38938
30-05-2023,Airport,Arrival,26716,6100,8652,41468
30-05-2023,Airport,Departure,20131,5730,10066,35927
31-05-2023,Airport,Arrival,25505,6068,9872,41445
31-05-2023,Airport,Departure,22826,5389,8800,37015
1/6/2023,Airport,Arrival,20546,7179,12366,40091
1/6/2023,Airport,Departure,24634,4705,7603,36942
2/6/2023,Airport,Arrival,20790,7106,13998,41894
2/6/2023,Airport,Departure,25777,5424,9255,40456
3/6/2023,Airport,Arrival,21994,6874,13837,42705
3/6/2023,Airport,Departure,23529,5541,9433,38503
4/6/2023,Airport,Arrival,27670,6524,11167,45361
4/6/2023,Airport,Departure,23879,6399,13374,43652
5/6/2023,Airport,Arrival,24346,7599,11046,42991
5/6/2023,Airport,Departure,22289,5146,13630,41065
6/6/2023,Airport,Arrival,22040,6600,9998,38638
6/6/2023,Airport,Departure,20839,5311,12450,38600
7/6/2023,Airport,Arrival,22181,7091,11169,40441
7/6/2023,Airport,Departure,24019,5207,9693,38919
8/6/2023,Airport,Arrival,20224,7703,12527,40454
8/6/2023,Airport,Departure,25665,5372,9277,40314
9/6/2023,Airport,Arrival,22644,7803,13943,44390
9/6/2023,Airport,Departure,28656,6098,10118,44872
10/6/2023,Airport,Arrival,23820,7774,12839,44433
10/6/2023,Airport,Departure,25582,6240,10075,41897
11/6/2023,Airport,Arrival,29850,7341,12122,49313
11/6/2023,Airport,Departure,24887,7718,13754,46359
12/6/2023,Airport,Arrival,25851,7833,11688,45372
12/6/2023,Airport,Departure,23858,6231,13239,43328
13-06-2023,Airport,Arrival,21896,6629,9941,38466
13-06-2023,Airport,Departure,22489,5807,11986,40282
14-06-2023,Airport,Arrival,25298,7680,11245,44223
14-06-2023,Airport,Departure,25344,5480,10755,41579
15-06-2023,Airport,Arrival,22195,8208,11798,42201
15-06-2023,Airport,Departure,26932,5879,9999,42810
16-06-2023,Airport,Arrival,24608,9457,12892,46957
16-06-2023,Airport,Departure,30940,6743,11165,48848
17-06-2023,Airport,Arrival,25502,9761,12059,47322
17-06-2023,Airport,Departure,28636,6931,10568,46135
18-06-2023,Airport,Arrival,30359,8100,10717,49176
18-06-2023,Airport,Departure,26651,8248,14259,49158
19-06-2023,Airport,Arrival,26655,8348,11303,46306
19-06-2023,Airport,Departure,25812,7566,12311,45689
20-06-2023,Airport,Arrival,23855,8073,11271,43199
20-06-2023,Airport,Departure,26739,6787,10960,44486
21-06-2023,Airport,Arrival,22675,9892,14279,46846
21-06-2023,Airport,Departure,35214,6129,8592,49935
22-06-2023,Airport,Arrival,23867,9776,15370,49013
22-06-2023,Airport,Departure,34628,5869,8749,49246
23-06-2023,Airport,Arrival,25065,8567,13386,47018
23-06-2023,Airport,Departure,28361,7173,10123,45657
24-06-2023,Airport,Arrival,27606,9188,11404,48198
24-06-2023,Airport,Departure,26411,8601,12818,47830
25-06-2023,Airport,Arrival,39182,7442,9427,56051
25-06-2023,Airport,Departure,26345,7490,17651,51486
26-06-2023,Airport,Arrival,32327,8718,11008,52053
26-06-2023,Airport,Departure,25836,6562,14260,46658
27-06-2023,Airport,Arrival,28042,8886,11190,48118
27-06-2023,Airport,Departure,26512,6352,11509,44373
28-06-2023,Airport,Arrival,26123,8692,12824,47639
28-06-2023,Airport,Departure,29414,6265,10172,45851
29-06-2023,Airport,Arrival,24811,9424,13501,47736
29-06-2023,Airport,Departure,30254,6436,10719,47409
30-06-2023,Airport,Arrival,27760,9113,11626,48499
30-06-2023,Airport,Departure,34517,6979,10231,51727
1/7/2023,Airport,Arrival,29135,8809,12864,50808
1/7/2023,Airport,Departure,33651,7453,11359,52463
2/7/2023,Airport,Arrival,33183,7609,10814,51606
2/7/2023,Airport,Departure,29331,8115,14435,51881
3/7/2023,Airport,Arrival,28230,8419,11053,47702
3/7/2023,Airport,Departure,28181,7455,11928,47564
4/7/2023,Airport,Arrival,26381,8203,10995,45579
4/7/2023,Airport,Departure,25746,7395,11472,44613
5/7/2023,Airport,Arrival,24535,8657,11581,44773
5/7/2023,Airport,Departure,28175,7675,10504,46354
6/7/2023,Airport,Arrival,24522,9347,12582,46451
6/7/2023,Airport,Departure,29703,7631,11112,48446
7/7/2023,Airport,Arrival,25806,8720,12305,46831
7/7/2023,Airport,Departure,30423,9063,10999,50485
8/7/2023,Airport,Arrival,27854,9083,11511,48448
8/7/2023,Airport,Departure,28920,9264,11348,49532
9/7/2023,Airport,Arrival,33380,8536,11044,52960
9/7/2023,Airport,Departure,27436,9977,13918,51331
10/7/2023,Airport,Arrival,28573,9022,11655,49250
10/7/2023,Airport,Departure,24758,9019,12184,45961
11/7/2023,Airport,Arrival,26522,8229,10344,45095
11/7/2023,Airport,Departure,24672,8807,11464,44943
12/7/2023,Airport,Arrival,25013,8736,11071,44820
12/7/2023,Airport,Departure,29315,8276,10703,48294
13-07-2023,Airport,Arrival,23530,9198,11504,44232
13-07-2023,Airport,Departure,32563,7735,10374,50672
14-07-2023,Airport,Arrival,24643,9066,12584,46293
14-07-2023,Airport,Departure,34893,8361,10589,53843
15-07-2023,Airport,Arrival,26122,9923,12772,48817
15-07-2023,Airport,Departure,35862,8380,10261,54503
16-07-2023,Airport,Arrival,32579,9280,10405,52264
16-07-2023,Airport,Departure,34280,9127,12684,56091
17-07-2023,Airport,Arrival,26834,8819,10865,46518
17-07-2023,Airport,Departure,28752,7727,11969,48448
18-07-2023,Airport,Arrival,28573,8774,10480,47827
18-07-2023,Airport,Departure,31324,8707,11337,51368
19-07-2023,Airport,Arrival,25777,8916,10499,45192
19-07-2023,Airport,Departure,33447,7497,10591,51535
20-07-2023,Airport,Arrival,26290,9971,10898,47159
20-07-2023,Airport,Departure,35090,7484,9224,51798
21-07-2023,Airport,Arrival,27289,9988,11401,48678
21-07-2023,Airport,Departure,37347,7923,10215,55485
22-07-2023,Airport,Arrival,30797,10386,10464,51647
22-07-2023,Airport,Departure,35806,8344,10150,54300
23-07-2023,Airport,Arrival,36167,9401,9435,55003
23-07-2023,Airport,Departure,34142,9455,12294,55891
24-07-2023,Airport,Arrival,33027,9695,10416,53138
24-07-2023,Airport,Departure,32111,8660,10691,51462
25-07-2023,Airport,Arrival,30609,9287,9728,49624
25-07-2023,Airport,Departure,30120,8796,10767,49683
26-07-2023,Airport,Arrival,29312,9293,10491,49096
26-07-2023,Airport,Departure,31562,8382,9538,49482
27-07-2023,Airport,Arrival,28153,9833,12120,50106
27-07-2023,Airport,Departure,31753,8257,9629,49639
28-07-2023,Airport,Arrival,31092,9267,13056,53415
28-07-2023,Airport,Departure,33697,8500,10523,52720
29-07-2023,Airport,Arrival,33259,9451,11623,54333
29-07-2023,Airport,Departure,32991,9384,11267,53642
30-07-2023,Airport,Arrival,38782,8816,9546,57144
30-07-2023,Airport,Departure,30611,9386,14231,54228
31-07-2023,Airport,Arrival,36712,8880,9336,54928
31-07-2023,Airport,Departure,29802,8729,12906,51437
1/8/2023,Airport,Arrival,30812,9363,9717,49892
1/8/2023,Airport,Departure,31117,8500,11304,50921
2/8/2023,Airport,Arrival,29923,10230,10866,51019
2/8/2023,Airport,Departure,31392,8275,10360,50027
3/8/2023,Airport,Arrival,28809,10845,11374,51028
3/8/2023,Airport,Departure,33470,9112,9425,52007
4/8/2023,Airport,Arrival,32578,10668,11934,55180
4/8/2023,Airport,Departure,35064,9204,10198,54466
5/8/2023,Airport,Arrival,34036,10593,11440,56069
5/8/2023,Airport,Departure,33318,9868,10901,54087
6/8/2023,Airport,Arrival,38747,9750,9670,58167
6/8/2023,Airport,Departure,30744,10743,12863,54350
7/8/2023,Airport,Arrival,35727,10492,9731,55950
7/8/2023,Airport,Departure,29719,9379,10943,50041
8/8/2023,Airport,Arrival,35289,9509,9675,54473
8/8/2023,Airport,Departure,28515,9586,10361,48462
9/8/2023,Airport,Arrival,33764,9825,11349,54938
9/8/2023,Airport,Departure,29091,9022,10091,48204
10/8/2023,Airport,Arrival,31809,11093,12789,55691
10/8/2023,Airport,Departure,31271,9647,9768,50686
11/8/2023,Airport,Arrival,33152,10503,13957,57612
11/8/2023,Airport,Departure,33209,9999,10314,53522
12/8/2023,Airport,Arrival,34920,10594,12990,58504
12/8/2023,Airport,Departure,31305,10339,11356,53000
13-08-2023,Airport,Arrival,41156,9604,9714,60474
13-08-2023,Airport,Departure,29389,10702,13740,53831
14-08-2023,Airport,Arrival,37153,10404,10705,58262
14-08-2023,Airport,Departure,26369,9600,14355,50324
15-08-2023,Airport,Arrival,32438,10015,9506,51959
15-08-2023,Airport,Departure,25862,9789,12579,48230
16-08-2023,Airport,Arrival,34337,11043,12109,57489
16-08-2023,Airport,Departure,30358,9528,11484,51370
17-08-2023,Airport,Arrival,29337,11794,12626,53757
17-08-2023,Airport,Departure,31089,9676,9710,50475
18-08-2023,Airport,Arrival,30820,10577,12511,53908
18-08-2023,Airport,Departure,33046,10190,9864,53100
19-08-2023,Airport,Arrival,33450,10866,11507,55823
19-08-2023,Airport,Departure,30005,10514,12007,52526
20-08-2023,Airport,Arrival,38282,10074,9790,58146
20-08-2023,Airport,Departure,31027,10887,13026,54940
21-08-2023,Airport,Arrival,34560,10869,10913,56342
21-08-2023,Airport,Departure,29598,8882,11879,50359
22-08-2023,Airport,Arrival,31478,10399,9763,51640
22-08-2023,Airport,Departure,28614,9218,10434,48266
23-08-2023,Airport,Arrival,30696,10355,10674,51725
23-08-2023,Airport,Departure,30237,8842,9319,48398
24-08-2023,Airport,Arrival,30161,11433,12802,54396
24-08-2023,Airport,Departure,31521,8863,9490,49874
25-08-2023,Airport,Arrival,30455,9972,13375,53802
25-08-2023,Airport,Departure,32667,9423,9963,52053
26-08-2023,Airport,Arrival,34538,9833,12254,56625
26-08-2023,Airport,Departure,30050,10056,10431,50537
27-08-2023,Airport,Arrival,39656,8331,9741,57728
27-08-2023,Airport,Departure,27120,10309,13422,50851
28-08-2023,Airport,Arrival,37403,8035,10346,55784
28-08-2023,Airport,Departure,23782,8776,13775,46333
29-08-2023,Airport,Arrival,35712,6805,8721,51238
29-08-2023,Airport,Departure,20919,9072,11287,41278
30-08-2023,Airport,Arrival,35539,6387,9328,51254
30-08-2023,Airport,Departure,21819,8119,9800,39738
31-08-2023,Airport,Arrival,34218,6968,11895,53081
31-08-2023,Airport,Departure,27985,9052,10421,47458
1/9/2023,Airport,Arrival,6434,1995,4885,13314
1/9/2023,Airport,Departure,12631,2236,3133,18000
2/9/2023,Airport,Arrival,20485,3888,9621,33994
2/9/2023,Airport,Departure,17227,4108,8726,30061
3/9/2023,Airport,Arrival,38551,7534,13640,59725
3/9/2023,Airport,Departure,29696,8181,13679,51556
4/9/2023,Airport,Arrival,25104,7747,13562,46413
4/9/2023,Airport,Departure,24421,6028,10505,40954
5/9/2023,Airport,Arrival,21009,6815,13623,41447
5/9/2023,Airport,Departure,23256,5736,9377,38369
6/9/2023,Airport,Arrival,19375,6115,11619,37109
6/9/2023,Airport,Departure,23934,6173,9454,39561
7/9/2023,Airport,Arrival,18505,7126,11938,37569
7/9/2023,Airport,Departure,26854,6151,10189,43194
8/9/2023,Airport,Arrival,20635,7171,12085,39891
8/9/2023,Airport,Departure,27792,7223,12607,47622
9/9/2023,Airport,Arrival,24767,6573,11913,43253
9/9/2023,Airport,Departure,24745,6404,14166,45315
10/9/2023,Airport,Arrival,30686,6525,11039,48250
10/9/2023,Airport,Departure,24273,8124,14915,47312
11/9/2023,Airport,Arrival,26799,7877,11036,45712
11/9/2023,Airport,Departure,21947,6198,11450,39595
12/9/2023,Airport,Arrival,23618,6425,9724,39767
12/9/2023,Airport,Departure,20815,6058,10092,36965
13-09-2023,Airport,Arrival,20446,6493,10696,37635
13-09-2023,Airport,Departure,23443,6017,9322,38782
14-09-2023,Airport,Arrival,20299,7057,12973,40329
14-09-2023,Airport,Departure,26944,6456,9851,43251
15-09-2023,Airport,Arrival,21772,7155,15124,44051
15-09-2023,Airport,Departure,29700,7420,10747,47867
16-09-2023,Airport,Arrival,23064,7078,16508,46650
16-09-2023,Airport,Departure,26775,6354,10908,44037
17-09-2023,Airport,Arrival,30245,7695,15366,53306
17-09-2023,Airport,Departure,23690,8470,14621,46781
18-09-2023,Airport,Arrival,27269,7913,14272,49454
18-09-2023,Airport,Departure,21918,6570,13179,41667
19-09-2023,Airport,Arrival,23477,6900,14344,44721
19-09-2023,Airport,Departure,21080,6456,11719,39255
20-09-2023,Airport,Arrival,21981,7262,13153,42396
20-09-2023,Airport,Departure,23701,6597,9960,40258
21-09-2023,Airport,Arrival,20120,7992,13948,42060
21-09-2023,Airport,Departure,27671,6946,11327,45944
22-09-2023,Airport,Arrival,22038,7345,13334,42717
22-09-2023,Airport,Departure,28072,8365,13291,49728
23-09-2023,Airport,Arrival,24195,8117,12530,44842
23-09-2023,Airport,Departure,24955,8882,16443,50280
24-09-2023,Airport,Arrival,31800,7542,10495,49837
24-09-2023,Airport,Departure,22343,9530,18615,50488
25-09-2023,Airport,Arrival,27288,7169,9588,44045
25-09-2023,Airport,Departure,19962,7844,15913,43719
26-09-2023,Airport,Arrival,24276,6603,8742,39621
26-09-2023,Airport,Departure,20244,11579,13541,45364
27-09-2023,Airport,Arrival,23082,7895,10780,41757
27-09-2023,Airport,Departure,23328,14471,11879,49678
28-09-2023,Airport,Arrival,22217,9367,14146,45730
28-09-2023,Airport,Departure,27189,18098,12176,57463
29-09-2023,Airport,Arrival,19472,10744,13086,43302
29-09-2023,Airport,Departure,34032,16384,9648,60064
30-09-2023,Airport,Arrival,19131,10952,11050,41133
30-09-2023,Airport,Departure,30486,14472,11537,56495
1/10/2023,Airport,Arrival,24302,9691,8106,42099
1/10/2023,Airport,Departure,19767,13546,15188,48501
2/10/2023,Airport,Arrival,41014,6836,7024,54874
2/10/2023,Airport,Departure,17657,12966,13221,43844
3/10/2023,Airport,Arrival,30253,10669,8509,49431
3/10/2023,Airport,Departure,17452,12166,11382,41000
4/10/2023,Airport,Arrival,23724,17404,11104,52232
4/10/2023,Airport,Departure,19253,11628,8668,39549
5/10/2023,Airport,Arrival,18140,24805,11780,54725
5/10/2023,Airport,Departure,21849,10906,7739,40494
6/10/2023,Airport,Arrival,15640,26785,14254,56679
6/10/2023,Airport,Departure,25111,9773,7973,42857
7/10/2023,Airport,Arrival,20087,17238,17340,54665
7/10/2023,Airport,Departure,22623,7292,8191,38106
8/10/2023,Airport,Arrival,24877,11925,14809,51611
8/10/2023,Airport,Departure,20355,5258,9891,35504
9/10/2023,Airport,Arrival,25629,11694,14644,51967
9/10/2023,Airport,Departure,21050,5549,14075,40674
10/10/2023,Airport,Arrival,22259,8040,14020,44319
10/10/2023,Airport,Departure,21069,4842,14863,40774
11/10/2023,Airport,Arrival,20500,7046,15813,43359
11/10/2023,Airport,Departure,24260,4383,10486,39129
12/10/2023,Airport,Arrival,19525,7395,18705,45625
12/10/2023,Airport,Departure,27723,4985,10554,43262
13-10-2023,Airport,Arrival,21013,6743,18944,46700
13-10-2023,Airport,Departure,31471,5052,11168,47691
14-10-2023,Airport,Arrival,23657,6629,17547,47833
14-10-2023,Airport,Departure,29791,5824,13902,49517
15-10-2023,Airport,Arrival,31351,6516,15586,53453
15-10-2023,Airport,Departure,26771,7004,17844,51619
16-10-2023,Airport,Arrival,27221,6600,14823,48644
16-10-2023,Airport,Departure,26057,5374,14935,46366
17-10-2023,Airport,Arrival,24767,5746,12906,43419
17-10-2023,Airport,Departure,23512,5010,13548,42070
18-10-2023,Airport,Arrival,23731,6517,14328,44576
18-10-2023,Airport,Departure,29422,4962,13611,47995
19-10-2023,Airport,Arrival,24194,7090,17346,48630
19-10-2023,Airport,Departure,35982,5093,14025,55100
20-10-2023,Airport,Arrival,26976,7098,18230,52304
20-10-2023,Airport,Departure,43454,4964,12620,61038
21-10-2023,Airport,Arrival,26306,6721,17891,50918
21-10-2023,Airport,Departure,41321,4901,13504,59726
22-10-2023,Airport,Arrival,32986,5575,14273,52834
22-10-2023,Airport,Departure,33443,6599,17043,57085
23-10-2023,Airport,Arrival,44012,5883,11442,61337
23-10-2023,Airport,Departure,27735,5656,17347,50738
24-10-2023,Airport,Arrival,37894,5664,12568,56126
24-10-2023,Airport,Departure,24572,5211,15264,45047
25-10-2023,Airport,Arrival,31366,6966,15500,53832
25-10-2023,Airport,Departure,24553,4988,12873,42414
26-10-2023,Airport,Arrival,27844,7690,18806,54340
26-10-2023,Airport,Departure,26774,6805,13563,47142
27-10-2023,Airport,Arrival,30029,6742,19482,56253
27-10-2023,Airport,Departure,28744,6101,14880,49725
28-10-2023,Airport,Arrival,34374,5938,16184,56496
28-10-2023,Airport,Departure,25240,5916,16099,47255
29-10-2023,Airport,Arrival,42145,6017,14850,63012
29-10-2023,Airport,Departure,23434,7239,20158,50831
30-10-2023,Airport,Arrival,33445,6698,15793,55936
30-10-2023,Airport,Departure,20704,6513,17500,44717
31-10-2023,Airport,Arrival,28347,5553,14692,48592
31-10-2023,Airport,Departure,19750,5628,15994,41372
1/11/2023,Airport,Arrival,23106,5839,17420,46365
1/11/2023,Airport,Departure,25371,4879,14241,44491
2/11/2023,Airport,Arrival,21600,6801,19381,47782
2/11/2023,Airport,Departure,27374,5027,15547,47948
3/11/2023,Airport,Arrival,22466,6921,18777,48164
3/11/2023,Airport,Departure,30458,5893,16105,52456
4/11/2023,Airport,Arrival,24508,5958,15954,46420
4/11/2023,Airport,Departure,27197,5776,18331,51304
5/11/2023,Airport,Arrival,32815,6009,14095,52919
5/11/2023,Airport,Departure,24816,7334,22667,54817
6/11/2023,Airport,Arrival,28983,6692,14944,50619
6/11/2023,Airport,Departure,23974,5890,18384,48248
7/11/2023,Airport,Arrival,24776,6080,14140,44996
7/11/2023,Airport,Departure,21555,5097,15157,41809
8/11/2023,Airport,Arrival,24037,6844,15675,46556
8/11/2023,Airport,Departure,25594,5180,13614,44388
9/11/2023,Airport,Arrival,21831,6779,17934,46544
9/11/2023,Airport,Departure,29534,4936,13345,47815
10/11/2023,Airport,Arrival,25355,7481,19469,52305
10/11/2023,Airport,Departure,32925,6167,14719,53811
11/11/2023,Airport,Arrival,25947,6642,18569,51158
11/11/2023,Airport,Departure,29323,6445,16021,51789
12/11/2023,Airport,Arrival,35824,7066,16238,59128
12/11/2023,Airport,Departure,27661,7634,20297,55592
13-11-2023,Airport,Arrival,29286,7737,18942,55965
13-11-2023,Airport,Departure,24590,5925,17591,48106
14-11-2023,Airport,Arrival,26317,6992,18959,52268
14-11-2023,Airport,Departure,22283,5105,15605,42993
15-11-2023,Airport,Arrival,24699,6562,17420,48681
15-11-2023,Airport,Departure,27163,5471,14468,47102
16-11-2023,Airport,Arrival,23658,7020,18940,49618
16-11-2023,Airport,Departure,29752,6421,15960,52133
17-11-2023,Airport,Arrival,27108,8040,19920,55068
17-11-2023,Airport,Departure,32684,7008,18924,58616
18-11-2023,Airport,Arrival,28825,7504,18461,54790
18-11-2023,Airport,Departure,29182,6095,20930,56207
19-11-2023,Airport,Arrival,36098,7661,15264,59023
19-11-2023,Airport,Departure,27629,7773,22397,57799
20-11-2023,Airport,Arrival,31921,7878,15598,55397
20-11-2023,Airport,Departure,25242,6062,18836,50140
21-11-2023,Airport,Arrival,27266,6607,14224,48097
21-11-2023,Airport,Departure,22445,5864,16508,44817
22-11-2023,Airport,Arrival,24692,7116,17692,49500
22-11-2023,Airport,Departure,26840,5876,14787,47503
23-11-2023,Airport,Arrival,22663,8120,22123,52906
23-11-2023,Airport,Departure,30243,7017,14453,51713
24-11-2023,Airport,Arrival,26174,8851,20132,55157
24-11-2023,Airport,Departure,32858,6261,15203,54322
25-11-2023,Airport,Arrival,28072,7133,19258,54463
25-11-2023,Airport,Departure,28285,6725,18332,53342
26-11-2023,Airport,Arrival,36579,7030,16198,59807
26-11-2023,Airport,Departure,24345,8586,24336,57267
27-11-2023,Airport,Arrival,31648,6978,15558,54184
27-11-2023,Airport,Departure,24492,6497,20235,51224
28-11-2023,Airport,Arrival,28415,6618,14297,49330
28-11-2023,Airport,Departure,22048,5692,17225,44965
29-11-2023,Airport,Arrival,25547,7285,16034,48866
29-11-2023,Airport,Departure,24251,5328,15607,45186
30-11-2023,Airport,Arrival,26534,8596,18331,53461
30-11-2023,Airport,Departure,28179,6086,16119,50384
1/12/2023,Airport,Arrival,26341,9150,19585,55076
1/12/2023,Airport,Departure,32765,6793,14458,54016
2/12/2023,Airport,Arrival,25662,7615,19047,52324
2/12/2023,Airport,Departure,28666,6647,16256,51569
3/12/2023,Airport,Arrival,32852,7089,16202,56143
3/12/2023,Airport,Departure,25897,8918,21124,55939
4/12/2023,Airport,Arrival,28788,7099,16063,51950
4/12/2023,Airport,Departure,25080,6762,17674,49516
5/12/2023,Airport,Arrival,26099,6301,15548,47948
5/12/2023,Airport,Departure,22063,6068,18099,46230
6/12/2023,Airport,Arrival,24137,7487,16217,47841
6/12/2023,Airport,Departure,24732,6029,15296,46057
7/12/2023,Airport,Arrival,24307,8038,19887,52232
7/12/2023,Airport,Departure,30018,6265,15403,51686
8/12/2023,Airport,Arrival,25974,8177,21979,56130
8/12/2023,Airport,Departure,34911,6688,15539,57138
9/12/2023,Airport,Arrival,26540,7858,20223,54621
9/12/2023,Airport,Departure,31438,6509,18217,56164
10/12/2023,Airport,Arrival,34183,9091,16180,59454
10/12/2023,Airport,Departure,26011,8147,23105,57263
11/12/2023,Airport,Arrival,34339,8245,14828,57412
11/12/2023,Airport,Departure,24695,6283,20773,51751
12/12/2023,Airport,Arrival,27256,7023,13653,47932
12/12/2023,Airport,Departure,24380,5793,17893,48066
13-12-2023,Airport,Arrival,25998,8516,15125,49639
13-12-2023,Airport,Departure,28228,5880,15201,49309
14-12-2023,Airport,Arrival,24045,9593,17832,51470
14-12-2023,Airport,Departure,33850,6646,14658,55154
15-12-2023,Airport,Arrival,26515,10080,19679,56274
15-12-2023,Airport,Departure,42655,7203,14204,64062
16-12-2023,Airport,Arrival,28719,9466,20593,58778
16-12-2023,Airport,Departure,41573,6747,15017,63337
17-12-2023,Airport,Arrival,34137,8924,17271,60332
17-12-2023,Airport,Departure,35055,9002,19672,63729
18-12-2023,Airport,Arrival,30491,8959,16624,56074
18-12-2023,Airport,Departure,32240,7299,18390,57929
19-12-2023,Airport,Arrival,27604,7482,14126,49212
19-12-2023,Airport,Departure,34354,6612,18754,59720
20-12-2023,Airport,Arrival,27385,7843,16123,51351
20-12-2023,Airport,Departure,43280,6032,17197,66509
21-12-2023,Airport,Arrival,27359,8892,19119,55370
21-12-2023,Airport,Departure,53031,5639,13931,72601
22-12-2023,Airport,Arrival,26002,10671,23867,60540
22-12-2023,Airport,Departure,62496,4497,11459,78452
23-12-2023,Airport,Arrival,26323,10697,27555,64575
23-12-2023,Airport,Departure,60449,4123,11604,76176
24-12-2023,Airport,Arrival,25635,7331,22560,55526
24-12-2023,Airport,Departure,44507,6719,14920,66146
25-12-2023,Airport,Arrival,30783,6998,20491,58272
25-12-2023,Airport,Departure,33244,6654,17880,57778
26-12-2023,Airport,Arrival,47795,5423,18787,72005
26-12-2023,Airport,Departure,36226,7091,20035,63352
27-12-2023,Airport,Arrival,44231,6525,20488,71244
27-12-2023,Airport,Departure,32681,6023,19592,58296
28-12-2023,Airport,Arrival,38178,7272,22689,68139
28-12-2023,Airport,Departure,30539,6340,18839,55718
29-12-2023,Airport,Arrival,35657,9403,25708,70768
29-12-2023,Airport,Departure,30471,8070,19384,57925
30-12-2023,Airport,Arrival,40884,8817,24382,74083
30-12-2023,Airport,Departure,27553,7546,21857,56956
31-12-2023,Airport,Arrival,50226,4912,14493,69631
31-12-2023,Airport,Departure,20485,5862,19225,45572
